20
**************************************************************
*************.....................................************
**..........................................................**
**..........................................................**
**..........................................................**
**..........................................................**
**................***********************...................**
*............................................................*
*............................................................*
*............................................................*                
*............................................................*
*............................................................*
*.................***********************....................*
**..........................................................**
**..........................................................**
**..........................................................**
**..........................................................**
**..........................................................**
*************....................................*************
**************************************************************