20
**************************************************************
*............................................................*
*............................................................*
*............................................................*
*............................................................*
*.............................****************...............*
*............................................................*
*............................................................*
*............................................................*
*............................................................*                
*..........................................**********........*
*............................................................*
*............................................................*
*............................................................*
*....************............................................*
*............................................................*
*............................................................*
*............................................................*
*............................................................*
**************************************************************