20
**************************************************************
**************************************************************
**..........................................................**
**..........................................................**
**..........................................................**
**..........................................................**
**................***********************...................**
**..........................................................**
**..........................................................**
**..........................................................**                
**..........................................................**
**..........................................................**
**................***********************...................**
**..........................................................**
**..........................................................**
**..........................................................**
**..........................................................**
**..........................................................**
**************************************************************
**************************************************************