20
**************************************************************
*............................................*...............*
*............................................*...............*
*............................................*...............*
*............................................*...............*
*............................................*...............*
*............................................*...............*
*............................................*...............*
*............................................*...............*
**************************************************************
*........................*...................................*
*........................*...................................*
*........................*...................................*
*........................*...................................*
*........................*...................................*
*........................*...................................*
*........................*...................................*
*........................*...................................*
*........................*...................................*
**************************************************************