20
**************************************************************
*............................................................*
**************.***********************************************
*............................................................*
*************************.************************************
*............................................................*
************************************************.*************
*............................................................*
************************************.*************************
*............................................................*   
***************.**********************************************
*............................................................*
******************.*******************************************
*............................................................*
*********************************.****************************
*............................................................*
***********************************.**************************
*............................................................*
*............................................................*
**************************************************************