20
**************************************************************
*.................................*..........................*
*.................................*..........................*
*.................................*..........................*
*********.........................*..........................*
*...*........................****************...............*
*...****.....................................*...............*
*......*......................................*..............*
*.......*......................................*.............*
*.......*.......................................*............*                
*.......*..................................*******************
*.......*....................................................*
*......*.....................................................*
*.....*......................................................*
*....************............................................*
*.............*..............................................*
*...............*............................................*
*................*...........................................*
*.................*..........................................*
**************************************************************