20
**************************************************************
*************.....................................************
**..........................................................**
**..........................................................**
**..........................................................**
**..........................................................**
**..........................................................**
*............................................................*
*............................................................*
*............................................................*                
*............................................................*
*............................................................*
*............................................................*
**..........................................................**
**..........................................................**
**..........................................................**
**..........................................................**
**..........................................................**
*************....................................*************
**************************************************************